WWWWWWWWWWWWWWWWWWWWWWWWW
W       W   T    W     PW
W   S   W        W      W
W       W               W
W       W               W
W            L   W   W  W
WM               W   W  W
WWWWWWWWW        W   W  W
W   G            W   W  W
W                W  TWW EW
WWWWWWWWWWWWWWWWWWWWWWWWWWW
W                 W                         
W                W                          
W           WWWWW                               
W                                          
W                                     WW     
W                                    W      
W                                   W       
W                                  W        
W                                 W         
W                                W          
W                               W           
W                              W            
W                             W             
W                            W              
W                          WW                
W                         W                 
W                        W                  
W                       W                   
W                      W                    
W                    WW                      
W                   W                       
W                  W                        
W                 W                         
X               WW                           
W              W                            
W             W                             
W            W                              
W           W                               
W          W                 WWWW               
W                          W                
W                         W                 
W                        W                  
W                      WW                    
W                     W                     
W                    W                      
W                   W                       
W                  W                        
WWWWWWWWWWWWWWWWWWWWWWWWWWWWWWWWWWWWWWWWWWW